# Dungeon Level Two (16x16)
# You can change width/height freely; parser handles variable-size maps.
# Keep all rows with the same number of symbols.

1111111111111111
1000000000000001
1000000001000E01
1000000001100001
1000000000000001
1000000000000001
1000001000000001
1000000000000001
10P000S001100001
1000000000000001
1011100000000001
1000000000000001
1000001000000001
1000000000001001
1000000000000001
1111111111111111
