# Dungeon Level Two (16x16)
# You can change width/height freely; parser handles variable-size maps.
# Keep all rows with the same number of symbols.

1111111111111111
1000000000000001
1001001001001E01
1001001001001001
1000001111001001
1001111111111001
1001001110001001
1001001111001001
1001000111001001
1001001111001001
1001111101111001
10010011110i0001
1001001001001001
10P10S1001001001
1000000000000001
1111111111111111
