# Dungeon Level Two (16x16)
# You can change width/height freely; parser handles variable-size maps.
# Keep all rows with the same number of symbols.

1111111111111111
1000000000000001
1000000000000E01
1000000000000001
1000000000000001
1000000000000001
1000000000000001
1000000000000001
100P000S00000001
1000000000000001
1000000000000001
1000000000000001
1000000000000001
1000000000000001
1000000000000001
1111111111111111
