# Dungeon Level Three (19x14)
# Final challenge level for yellow unlock quiz (green channel restoration).
# Keep rows with equal width.

1111111111111111111
1000000000000000001
10P0011111110000001
1000010000010000001
1000010000010001001
1000000000010001001
1001111000010001001
1001000000010001001
1001000111110001001
1001000b000s0001001
1001000i0000b001001
100100000000N000001
1000000000000000001
1111111111111111111
